pity = жаль / відчуття провини
tool = інструмент / знаряддя
slim = стройний / в хорошій формі
quiz = вікторина
comb = гребінець / розчіска
keen = страсно захоплюючий / гострий
bright = яркий
tights = колготки
slippers = домашні тапочки
vest = майка / жилет
tie = галстук / зав'язувати
gloves = рукавиці
suit = костюм
socks = носки
scarf = шарф
dressing gown = халат
round = круглий / навколо
petrol = бензин
pear = грушка
rate = темп / рівень
loss = втрата / збиток
lend = позичати / давати в борг
shoe = черевик
sink = тонути / раковина
ring = обручка / звонити / круг
ride = їхати верхом / кататися
rare = рідкісний / сирий / розріджений
bunny = кролик / зайчик
hen = курка-несучка
puppy = собачення
goat = козел
ant = мураха / комаха
camel = верблюд
bee = бджола
kangaroo = кенгуру
giraffe = жираф
parrot = попугай
sheep = вівця
ram = баран
chicken = курка
frog = жаба
insect = комаха
butterfly = метелик
turtle = черепаха
bat = кажан / летюча миша
duck = качка
wings = крила
satisfied = задоволений
passion = пристрасть
worst = найгірший
cross = хрест / перекреслювати / перетинати
least = найменше
fair = справедливий / ярмарка
bit = трішки / небагато
kid = дитина / обманювати
dish = блюдо (тарілка)
quite = цілком / вдосталь
upon = на
deny = заперечувати / відмовити
edge = край
burn = спалити / горіти / опік
wild = дикий
camp = табір
stuff = матеріал / речі
proud = гордий / гордитися
treat = звертатися / лікувати
treatment = лікування
fit = підходить / відповідати / співпадати
weigh = зважувати / важити
weight = вага / вантаж
bake = пекти / запікати
term = термін / семестр
evil = зло / злий
hole = діра / отвір / дупло
tidy = охайний / акуратний
avoid = уникати
unfairly = несправедливо
pond = ставок / став
stone = камінь / кісточка
heat = жара / тепло / опалення
rainbow = веселка
plant = рослина / завод
peace = мир
steal = вкрасти
sick = хворий
spell = вимовляти по буквам / писати по буквам
cosy = затишний / комфортний
post = пошта / пост
wage = заробітня плата
mine = мій / шахта / міна / видобувати
court = суд
shake = струсити / пожимати руки / тремтіти
civil = цивільний
blame = звинувачувати / вина
admit = визнавати
along = вздовж
terms = умови
grade = оцінка / клас
claim = претензія / вимога / заявляти
delay = затримуватись / затримка
sense = почуття / сенс
judge = суддя / судити
fully = повністю
used = використаний / звиклий / той що використовується
vowel = голосний звук
tend = мати схильність / мати тенденцію
theme = тема
frame = рамка / каркас
carry = нести
sauce = соус
trial = пробний / суд
pool = басейн
berry = ягода
yawn = позіхати / зівати
diary = щоденник
noisy = шумний
lorry = фура
chain = ланцюг
skate = кататися на коньках / коньки
climb = лізти / підніматись
goose = гусак
aloud = вголос
sheet = простирадло
towel = рушник
cause = завдавати / причина / спричиняти
aged = у віці / похилого віку
stage = етап / стадія / театр
deaf = глухий
dozen = дюжина
stick = приклеювати / липнути / палиця
alike = схожий / однаковий
rather = замість
stamps = марки
embroidery = вишивка
knitting = в'язання
calming = заспокійливий
costly = дорогий
enjoyable = приємний
exciting = захоплююче
hopeless = безнадійний
exhibition = виставка
occur = відбуватися
argue = сперечатися
policy = політика
awful = жахливий
drown = тонути
scale = ваги / масштаб
sight = погляд / вигляд
adverb = прислівник
brush = щітка / чистити
force = сила / збройні сили
broad = широкий
serve = служити / обслуговувати
board = дошка
grass = трава / пасовище
tough = жорсткий / міцний
cruel = жорстокий
count = рахувати / підрахунок
major = основний / важливий / майор
swear = присягатися / присяга / клятва
sweep = підмітати = Definition of Sweep@to clean an area by brushing away litter and dust@Examples of Sweep in a sentence@I have to sweep the front porch because it is so dusty.@If you want to sweep the living room you will have to use a broom.@Maria used her hand to sweep the scraps of paper off of her desk.@You should use a dustpan and a broom if you plan to sweep.@I used my foot to sweep away the piece of trash on the floor.@
gap = розрив / пробіл / діра = Definition of Gap@a space in between two things@Examples of Gap in a sentence@The gap between the seat and the center console was just wide enough for the keys to fall down in.@A gap in the man’s work history made the manager wonder what he did for work during that period of time.@Because she didn’t like the space between her two front teeth, the girl had the dentist remove the gap.@The gap between the wall and the bathtub should be filled in if you want to avoid mold growth.@Diving into the gap, the baseball player was able to fill in the area where no other player stood.@
