pear = грушка
rate = темп / рівень
loss = втрата / збиток
lend = позичати / давати в борг
shoe = черевик
sink = тонути / раковина
ring = обручка / звонити / круг
ride = їхати верхом / кататися
rare = рідкісний / сирий / розріджений
bunny = кролик / зайчик
hen = курка-несучка
puppy = собачення
goat = козел
ant = мураха / комаха
camel = верблюд
bee = бджола
kangaroo = кенгуру
giraffe = жираф
parrot = попугай
sheep = вівця
ram = баран
chicken = курка
frog = жаба
insect = комаха
butterfly = метелик
turtle = черепаха
bat = кажан / летюча миша
duck = качка
wings = крила
satisfied = задоволений
passion = пристрасть
worst = найгірший
cross = хрест / перекреслювати / перетинати
least = найменше
fair = справедливий / ярмарка
bit = трішки / небагато
kid = дитина / обманювати
dish = блюдо (тарілка)
quite = цілком / вдосталь
upon = на
deny = заперечувати / відмовити
edge = край
burn = спалити / горіти / опік
