Deer - олень
Sword - меч
Staff - палиця 
Bow / bowman - лук / лучник
Quarterstaff - кийок / палиця з залізним наконечником
Suddenly - раптово
Mock / mockingly - насміюватись / насмішливо
Excellently - чудово
Hang - висіти
Arrow - стріла
Wandering - блукаючи
Narrow - вузький
Huge - величезний
Tall - високий
Thick - товстий
Remain - залишатися
Motionless - нерухомо
Fierce / fiercely - лютий / люто
*****************************************
river bank - берег річки
climbed up - піднятися вгору
fellow - приятель
horn - ріг
blew it - подути в нього
to throw - кидати
shout - кричати
Do forgive me - вибач мене
courage / courageous - мужність / мужній
burst - лопнути
wood - деревина
thus - таким чином
actually - насправді / фактично
surely - точно / невпинно / обов'язково
knight - рицар
mill - млин | miller - мільник
***************************************** p.3
fair - справедливий / чесний
proud - гордий
to borrow - позичати / брати у борг
abbey - монастир
