combining = об'єднувати / добавляти
foul = брудний / вонючий
dirty = брудний
beware = застерігати
awake = не спати
your majesty = ваша величність
curse = прокляття
pursuade = вмовляти / переконувати
enemy = ворог
glove = рукавиця
conceal = ховати
overdue = той який запізнився / просрочений
hang = висіти
upset = розстроєний / збентежений
courage = хоробрість
ashore = до берега
watch you step = дивіться під ноги
fault = вина
snack = легка закуска
mysterious = таємничий / загадковий
exploit = експортувати / використати
sore = болісний / безкорисний
roam = бродити
elated = піднесений / в захваті
gassy = балакучий / хвастливий
gown = платя / вечірнє плаття
fatchingly = незграбно
drape = кидатися / накидуватися
sophisticated = витончений
grace = грація / благодать / пристойність
suddenly = раптово
stranger = незнайомець
fair = справедливий
stuff = засовувати / запихати
bizarre = химерний / дивний
agony = агонії / кохання
guard = охорона
goodness = доброта
awkward = незручно
georgeous = чудовий / прекрасний
supposed = мнимий / чи той ким його вважають
fuller = повна / товста
fitting = підходящий / придатний
swoon = знепритомніти
agile = рухомий / спритний
peacock = павич
speaking of = говорячи про
shut = закривати